Localidades;Ecosistema;Coleop;Dipter;Himeno;Hemip;Lepid;Ab
S1;E1;3;4;4;6;1;18
S2;E1;5;1;1;7;3;17
S3;E1;6;2;0;2;6;16
S4;E1;1;1;1;0;3;6
S5;E1;4;7;3;6;2;22
S6;E2;2;2;5;1;0;10
S7;E2;0;4;1;1;1;7
S8;E2;0;6;4;3;5;18
S9;E2;7;6;5;1;4;23
S10;E2;2;1;4;3;1;11
